       ######
#########  ###
#.     &B    #
####  #### # #
   #  #      #
   #  # # ####
   #      #
   #  #####
   #####

