#########
#. B&####
#### ####
#### ####
#########
